"year","nerkids","Kokanee","propKokanee","Sockeye","propSox","NOsockeye","propNO","HOsockeye","propHO"
"2009",4041,12,0.3,4029,99.7,2006,49.8,2023,50.2
"2010",17857,18,0.1,17839,99.9,14985,84,2854,16
"2011",2237,29,1.3,2208,98.7,1548,70.1,660,29.9
"2012",3209,6,0.2,3203,99.8,2316,72.3,887,27.7
"2013",2116,8,0.4,2108,99.6,476,22.6,1632,77.4
"2014",1495,6,0.4,1489,99.6,1354,90.9,135,9.1
"2015",188,2,0.9,186,99.1,180,96.6,6,3.4
"2017",167,2,1.3,165,98.7,165,100,0,0
"2018",250,0,0,250,100,246,98.6,4,1.4
"2019",54,0,0.7,54,99.3,0,0,0,100
"2020",1441,0,0,1441,100,1402,97.3,39,2.7
"2021",40,0,1.1,40,98.9,38,96.2,2,3.8
